1111111111
1P00000001
1000C00001
1000011001
1C0000C001
1000111001
1000000E01
1111111111