111111111111111
1P0000000000001
100C00000C00001
100000000000001
100000000000001
1C0000000000C01
100000000000001
100000000000001
1000000000000E1
111111111111111